A##                 #########
    ###################   # #
# ####                  # # #
# ########## ######## # # # #
#                     # # # #
######## ############ # # # #
#   ##   #            # # # #
# # ## # # ## ######### # # #
# #    #   ## #           # #
# # ## ###### ######### # # #
### ##             #### # # #
### ############## ## #   # #
###             ##    # # # #
###### ######## ####### # # #
###### ####             #
       #####################B
