A #                 #########
#   ###################   # #
# ####                # # # #
# ########## ######## # # # #
#                     # # # #
##################### # # # #
#   ##                # # # #
# # ## ### ## ######### # # #
# #    #   ## #         # # #
# # ## ################ # # #
### ##             #### # # #
### ############## ## # # # #
###             ##    # # # #
###### ######## ####### # # #
###### ####             #    
       #####################B
